Shelley	Charrette
Kliment	Pitblado
Brandea	Keinrat
Dominik	Aspin
Moe	Tidridge
Malanie	Waiting
Rickie	Sherlock
Normy	Sallows
Diann	Gowler
Anjela	Abramski
Aurelie	Mee
Ebony	Yakushkin
Agnola	Lyst
Ashil	Mocquer
Neille	Spurryer
Matteo	Sawford
Osmund	Troake
Farlay	Vlahos
Stearne	Garmons
Jacqui	McMechan
Levi	Pressman
Yasmin	Gensavage
Patrizius	Royal
Marcellina	Eustis
Brandy	D'Alessio
Chrissy	Jekel
Francklyn	Castella
Drud	Aleksandrov
Bronson	McClay
Karon	Berston
Ruthi	Barock
Edwin	Fraschetti
Hatty	Tedstone
Jermaine	Bilborough
Reynold	Arrowsmith
Hallie	Viggars
Kacie	Macci
Onida	Baudain
Wallie	Spare
Alasteir	Veart
Arda	Haylands
Trip	Blandamere
Greer	Cawker
Even	Raycroft
Loria	Rennles
Webb	Judgkins
Rudyard	Fosken
Yvonne	Bruckman
Hyacinthia	Jermin
Jasmina	Jenkinson
Nertie	Eayres
Terrijo	Scamp
Belita	Mulder
Terza	Trolley
Carmine	Bassom
Arlette	Allward
Lazar	Verney
Jeffry	Lyenyng
Thia	Gosson
Charity	MacKniely
Tasha	Eastmead
Augie	Brakespear
Ravi	Impleton
Dina	Lemonnier
Justino	MacGraith
Franchot	Glasheen
Jodie	Wildash
Farr	Beaston
Konstanze	Norfolk
Maximo	Thonger
Hall	Gymlett
Adam	Waterstone
Rowena	Spadeck
Callie	Hapgood
Marissa	Fagg
Hyacinthia	Gilardengo
Shane	Hecks
Jessamyn	Crossgrove
Francisca	Garroch
Yehudit	Le Barr
Ardath	Lillicrop
Trula	Fulun
Cornela	Footer
Chrystal	Aiskrigg
Sophi	Gonzalez
Maximilianus	Dwerryhouse
Susana	Minguet
Thaddeus	Corroyer
Gretta	Bonicelli
Barney	Pyecroft
Gasparo	Couves
Ferrell	Sheridan
Michele	Prettjohn
Abrahan	Jacqueminet
Rad	Bremmer
Hermann	Persse
Udall	Caldicott
Mariejeanne	Fones
Darryl	Whitebrook
Michel	Osant
Shoshanna	Mumby
Norry	Verma
Rogerio	Bass
Fernande	Jurczak
Phyllida	Haskey
Arturo	Ackland
Loydie	MacGraith
Lila	Ivanishchev
Nigel	Lowdeane
Saul	Bufton
Harlin	Wallington
Lionello	Clouston
Stanislaus	Meade
Clayson	Scantleberry
Lark	Clitheroe
Finley	Martina
Meade	Mordaunt
Klement	Ors
Lefty	Greenrodd
Lenci	Espinay
Candi	Hobbing
Seka	Gon
Drucill	Kyles
Natividad	Payler
Torrie	Tomasoni
Art	Kennelly
Brit	McVicker
Alvy	Thirsk
Marice	Newall
Shaylyn	Gwynn
Mona	Bonafant
Rupert	Philps
Lonnie	Hould
Larisa	Gobbet
Crosby	Sapseed
Melony	Davidy
Melissa	Doni
Hobart	McLellan